0000000000
0100010000
0111011110
0001110100
0001000100
0011011110
0100010000
0010011110
0100100010
0000000000